10
S........#
.######..#
.#.......#
.#...###.#
.#.....#..
.........#
###..###..
..#..#....
..##.#....
.........G
