12
S..........#
.##..##....#
.#.........#
.#...###...#
.#.....#...#
...........#
.##..###...#
..#.........
..##.#.....#
#.......#...
#....####...
...........G
