15
S.............#
.##..##.......#
.#............#
.#......###...#
.#........#...#
..............#
..............#
.##.....###...#
..#............
..##.#........#
#.......#......
..............#
#.......####...
..............#
..............G