20
S.................##
####..######.###...#
.#............#..#.#
.#...###.#.........#
.#...###......###..#
...........#.......#
###...........######
.....#..##..######.#
..##.#.............#
............#......#
#.................##
####..######.###...#
.#............#..#.#
.#...###.#.........#
.#...###......###..#
...........#.......#
###...........######
.....#..##..######.#
..##.#.............#
............#......G